....................
....................
....................
..........X.........
.........###........
....................
####...C....C....###
......--------......
....-...........-...
....................
.G.G............G.G.
----.....G......----
....................
....G....1....G.....
####################
