....................
....................
............G.......
....................
....................
........G...........
........-...........
...............-....
....................
....#......--.......
...##...............
...##..-.......##...
...##..........##...
.X.##C.G.C.G..G##.1.
####################
