........GG..........
....................
....-...##..........
...........-........
...............-....
....................
....G...............
...........--.....GG
....................
...............G....
...G...........--...
.......G............
..................--
.X.#CCCCCCCCCCCCC#1.
####################
