.X..........1.......
.-..................
....................
..................--
.-..................
..................GG
--................-.
................G...
..--...........GG...
......--........-...
....................
.........--.........
......--....--......
...--..........--...
####################
