....................
....................
....................
...G..GGG..G........
...G..G.G..G........
...G..G.G..G........
...G..GGG..G........
..................-.
..............C.....
..........C..--.....
.....#....--....-...
....##..C....C......
...#.#..--..--......
.X#.C#....C........1
####################
