X........1..........
#..................#
.#.............-..#.
..#...........GG.#..
...#...........-.#..
...#.............#..
...#..........G..#..
...#-..........-.#..
...#.............#..
...#-.........GG.#..
...#..GG......-..#..
...#..-..........#..
....#....G.-....#...
.....#.........#....
####################
