....................
....................
....................
....................
....................
....................
....................
....................
.X...............1..
---.............---.
...............G...
....-............-..
......G...G.....GG..
....................
####################
