..........X.........
.G................G.
.-......-----.....-.
....................
.#................#.
....................
....................
.#................#.
....................
....#..........#....
....................
.-................-.
....................
..........1.........
####################
